13
18
++++++++++++++++++
++++++++++++++++++
++++++++++++++++++
++++++####++++++++
++++++# .#++++++++
++++++#  ###++++++
++++++#*@  #++++++
++++++#  $ #++++++
++++++#    #++++++
++++++######++++++
++++++++++++++++++
++++++++++++++++++
++++++++++++++++++
STOP

